㠁嵯	初開三侵平 初開三支平
一些	影開三A真入 心開三麻平
一切	影開三A真入 清開四齊去
一種	影開三A真入 章三鍾上
一般	影開三A真入 幫二刪平
一覺	影開三A真入 見開二肴去
丁丁	知開二耕平 知開二耕平
丁丁	端開四青平 端開四青平
万俟	明一登入 羣開三C之平
三台	心開一談平 透開一咍平
三觀	心開一談平 見合一寒平
上朝	常開三陽上 澄開三宵平
上校	常開三陽上 匣開二肴去
上諭	常開三陽去 以合三虞去
下海	匣開二麻去 曉開一咍上
下載	匣開二麻上 從開一咍去
不勝	幫三C文入 書開三蒸平
不悖	幫三C文入 並一魂入
不禁	幫三C文入 見開三B侵平
不要	幫三C文入 影開三A宵去
不錯	幫三C文入 清開一唐入
丞相	常開三蒸平 心開三陽去
並行	並四青上 匣開二庚平
中意	知三東去 影開三C之去
中校	知三東平 匣開二肴去
中的	知三東去 端開四青入
中肯	知三東去 溪開一登上
中行	知三東平 匣開一唐平
主要	章合三虞上 影開三A宵去
乾了	見開一寒平 來開四蕭上
乾元	羣開三B仙平 疑合三C元平
乾兒	見開一寒平 日開三支平
乾冰	見開一寒平 幫三B蒸平
乾咳	見開一寒平 溪開一登入
乾唱	見開一寒平 昌開三陽去
乾嘔	見開一寒平 影一侯上
乾嚎	見開一寒平 匣開一豪平
乾坤	羣開三B仙平 溪合一魂平
乾妹	見開一寒平 明一灰去
乾媽	見開一寒平 明二麻平
乾安	羣開三B仙平 影開一寒平
乾屍	見開一寒平 書開三脂平
乾旱	見開一寒平 匣開一寒上
乾杯	見開一寒平 幫一灰平
乾枯	見開一寒平 溪一模平
乾柴	見開一寒平 崇開二佳平
乾洗	見開一寒平 心開四齊上
乾涸	見開一寒平 匣開一唐入
乾淨	見開一寒平 從開三清上
乾渴	見開一寒平 溪開一寒入
乾溼	見開一寒平 書開三侵入
乾澀	見開一寒平 生開三侵入
乾燒	見開一寒平 書開三宵平
乾燥	見開一寒平 心開一豪上
乾爸	見開一寒平 並一歌上
乾爹	見開一寒平 端開四麻平
乾爽	見開一寒平 生開三陽上
乾癟	見開一寒平 滂三A仙入
乾白	見開一寒平 並二庚入
乾硬	見開一寒平 疑開二耕去
乾等	見開一寒平 端開一登上
乾粉	見開一寒平 幫三C文上
乾糧	見開一寒平 來開三陽平
乾紅	見開一寒平 匣一東平
乾絲	見開一寒平 心開三之平
乾縣	羣開三B仙平 匣合四先去
乾耗	見開一寒平 曉開一豪去
乾肉	見開一寒平 日三東入
乾脆	見開一寒平 清合三祭去
乾花	見開一寒平 曉合二麻平
乾裂	見開一寒平 來開三仙入
乾貝	見開一寒平 幫一泰去
乾貨	見開一寒平 曉合一歌去
乾透	見開一寒平 透一侯去
乾酪	見開一寒平 來開一唐入
乾重	見開一寒平 澄三鍾上
乾陵	羣開三B仙平 來開三蒸平
乾隆	羣開三B仙平 來三東平
乾飯	見開一寒平 並三C元上
乾麪	見開一寒平 明四先去
于嗟	曉合三C虞平 精開三麻平
于闐	云合三C虞平 定開四先去
亟待	見開三C蒸入 定開一咍上
亢宿	見開一唐平 心三尤去
交易	見開二肴平 以開三清入
交質	見開二肴平 知開三脂去
人種	日開三真平 章三鍾上
人質	日開三真平 知開三脂去
今上	見開三B侵平 常開三陽去
今朝	見開三B侵平 知開三宵平
令狐	來開四青平 匣一模平
以爲	以開三之上 云合三B支平
仲夏	澄三東去 匣開二麻去
休假	曉三C尤平 見開二麻去
休屠	曉三C尤平 澄開三魚平
但使	定開一寒上 生開三之上
住口	知合三虞去 溪一侯上
住嘴	知合三虞去 精合三支上
住宿	澄合三虞去 心三東入
住店	澄合三虞去 端開四添去
住手	知合三虞去 書三尤上
何種	匣開一歌平 章三鍾上
佛教	並三C文入 見開二肴去
作爲	精開一唐入 云合三B支平
使用	生開三之上 以三鍾去
使節	生開三之去 精開四先入
使館	生開三之去 見合一寒去
來使	來開一咍平 生開三之去
侗族	定一東去 從一東入
侗水	定一東去 書合三脂上
供奉	見三C鍾平 並三C鍾上
便便	並三A仙平 並三A仙平
促使	清三鍾入 生開三之上
保藏	幫一豪上 從開一唐平
信函	心開三真去 匣開二咸平
倉頡	清開一唐平 匣開四先入
倍數	並一灰上 生合三虞去
倒數	端開一豪去 生合三虞上
倒數	端開一豪去 生合三虞去
倒車	端開一豪去 昌開三麻平
值得	澄開三蒸入 端開一登入
值日	澄開三之去 日開三真入
值錢	澄開三蒸入 從開三仙平
假使	見開二麻上 生開三之上
假日	見開二麻去 日開三真入
假期	見開二麻去 羣開三C之平
偏少	滂三A仙平 書開三宵上
停車	定開四青平 昌開三麻平
傅說	幫三C虞去 以合三仙入
傍晚	並一唐去 明三C元上
傳承	澄合三仙平 常開三蒸平
傳統	澄合三仙平 透一冬去
傳記	澄合三仙去 見開三C之去
傳說	澄合三仙平 書合三仙入
傳開	澄合三仙平 溪開一咍平
僕射	並一冬入 以開三麻去
僮侗	澄二江去 定一東去
僮族	澄二江去 從一東入
僮泰	澄二江去 透開一泰去
儲藏	澄開三魚平 從開一唐平
元朝	疑合三C元平 澄開三宵平
充值	昌三東平 澄開三蒸入
充分	昌三東平 並三C文去
全勝	從合三仙平 書開三蒸去
兩種	來開三陽上 章三鍾上
公使	見一東平 生開三之去
典當	端開四先上 端開一唐去
典質	端開四先上 知開三脂去
再見	精開一咍去 見開四先去
冠以	見合一寒去 以開三之上
冠詞	見合一寒去 邪開三之平
冠軍	見合一寒去 見合三C文平
冤句	影合三C元平 羣合三C虞平
出使	昌合三真入 生開三之去
出差	昌合三真入 初開二佳平
出差	昌合三真入 初開二皆平
出發	昌合三真入 幫三C元入
函數	匣開一覃平 生合三虞去
分别	幫三C文平 幫三B仙入
分子	並三C文去 精開三之上
分子	幫三C文平 精開三之上
分行	幫三C文平 匣開一唐平
切割	清開四先入 見開一寒入
切實	清開四齊去 船開三真入
切普	清開四先入 滂一模上
切韻	清開四先入 云合三C文去
判斷	滂一寒去 端合一寒去
刺客	清開三支去 溪開二庚入
刺殺	清開三支去 生開二山入
前燕	從開四先平 影開四先平
前藏	從開四先平 從開一唐去
勝仗	書開三蒸去 澄開三陽去
勝任	書開三蒸平 日開三侵去
勝利	書開三蒸去 來開三脂去
勝券	書開三蒸去 溪合三C元去
勝地	書開三蒸去 定開四脂去
勞軍	來開一豪去 見合三C文平
北朝	幫一登入 澄開三宵平
北燕	幫一登入 影開四先平
區別	溪合三C虞平 幫三B仙入
南下	泥開一覃平 匣開二麻去
南朝	泥開一覃平 澄開三宵平
南燕	泥開一覃平 影開四先平
占卜	章開三鹽平 幫一東入
即使	精開三蒸入 生開三之上
厭惡	影開三A鹽去 影一模去
參商	生開三侵平 書開三陽平
參宿	生開三侵平 心三尤去
參差	初開三侵平 初開三支平
參數	清開一覃平 生合三虞去
參與	清開一覃平 以開三魚去
參觀	清開一覃平 見合一寒平
參鼓	清開一覃去 見一模上
反應	幫三C元上 影開三C蒸去
反相	幫三C元上 心開三陽去
反覆	幫三C元上 滂三C東入
口号	溪一侯上 匣開一豪去
句當	見一侯去 端開一唐去
句讀	見合三C虞去 定一侯去
只讀	章開三支上 定一東入
召喚	澄開三宵去 曉合一寒去
召工	常開三宵去 見一東平
可汗	溪開一歌上 匣開一寒平
台州	透開一咍平 章三尤平
右轉	云三C尤上 知合三仙上
号令	匣開一豪去 來開三清去
号召	匣開一豪去 澄開三宵去
号碼	匣開一豪去 明二麻上
号角	匣開一豪去 見二江入
各種	見開一唐入 章三鍾上
同好	定一東平 曉開一豪去
同種	定一東平 章三鍾上
名勝	明三A清平 書開三蒸去
名將	明三A清平 精開三陽去
吞咽	透開一痕平 影開四先去
吞嚥	透開一痕平 影開四先去
周易	章三尤平 以開三清入
周朝	章三尤平 澄開三宵平
命令	明三B庚去 來開三清去
咎繇	見開一豪平 以開三宵平
咽喉	影開四先平 匣一侯平
咽部	影開四先平 並一侯上
咽音	影開四先平 影開三B侵平
哽咽	見開二庚上 影開四先入
唐朝	定開一唐平 澄開三宵平
商朝	書開三陽平 澄開三宵平
商賈	書開三陽平 見一模上
喋血	端開四添入 曉合四先入
喜好	曉開三C之上 曉開一豪去
單于	常開三仙平 云合三C虞平
單挑	端開一寒平 定開四蕭上
單縣	常開三仙去 匣合四先去
單調	端開一寒平 定開四蕭去
嗚呼	影一模平 曉一模平
噬嗑	常開三祭去 匣開一談入
回覆	匣合一灰平 滂三C東入
回鶻	匣合一灰平 匣合一魂入
因爲	影開三A真平 云合三B支去
固相	見一模去 心開三陽去
圈地	溪合三B仙平 定開四脂去
圈套	溪合三B仙平 透開一豪去
圈子	溪合三B仙平 精開三之上
圈養	羣合三C元上 以開三陽上
圓圈	云合三B仙平 溪合三B仙平
土著	透一模上 澄開三陽入
壟斷	來三鍾上 定合一寒上
夏商	匣開二麻上 書開三陽平
夏天	匣開二麻去 透開四先平
夏季	匣開二麻去 見合三A脂去
夏朝	匣開二麻上 澄開三宵平
多少	端開一歌平 書開三宵上
多數	端開一歌平 生合三虞去
多種	端開一歌平 章三鍾上
大使	定開一泰去 生開三之去
大將	定開一泰去 精開三陽去
大校	定開一泰去 匣開二肴去
大汗	定開一泰去 匣開一寒去
大汗	定開一泰去 匣開一寒平
大燕	定開一泰去 影開四先平
大行	定開一泰去 匣開一唐平
大行	定開一泰去 匣開二庚平
大辟	定開一泰去 並三A清入
天台	透開四先平 透開一咍平
太守	透開一泰去 書三尤去
太監	透開一泰去 見開二銜去
太行	透開一泰去 匣開一唐平
契丹	溪開三C殷入 端開一寒平
契約	溪開四齊去 影開三C陽入
契闊	溪開四先入 溪合一寒入
好處	曉開一豪上 昌開三魚去
姓曾	心開三清去 精開一登平
委蛇	影合三B支平 以開三支平
姥姥	來開一豪上 來開一豪上
姥爺	來開一豪上 以開三麻平
嫪毐	來開一豪去 影開一咍上
子女	精開三之上 孃開三魚上
孑孓	見開三A仙入 見三C鍾上
孝弟	曉開二肴去 定開四齊去
孝悌	曉開二肴去 定開四齊去
學校	匣二江入 匣開二肴去
宋朝	心一東去 澄開三宵平
宗教	精一冬平 見開二肴去
宮殿	見三C東平 定開四先去
宰予	精開一咍上 以開三魚平
宰相	精開一咍上 心開三陽去
容易	以三鍾平 以開三支去
宿舍	心三東入 書開三麻去
寒假	匣開一寒平 見開二麻去
寶藏	幫一豪上 從開一唐去
將帥	精開三陽去 生合三脂去
將領	精開三陽去 來開三清上
尊重	精合一魂平 澄三鍾上
對應	端合一灰去 影開三C蒸去
少兒	書開三宵去 日開三支平
少商	書開三宵去 書開三陽平
少年	書開三宵去 泥開四先平
少數	書開三宵上 生合三虞去
少有	書開三宵上 云三C尤上
少校	書開三宵去 匣開二肴去
少衝	書開三宵去 昌三鍾平
少量	書開三宵上 來開三陽去
少陰	書開三宵去 影開三B侵平
少陽	書開三宵去 以開三陽平
尺度	昌開三清入 定一模去
居住	見開三C魚平 澄合三虞去
崋山	匣合二麻去 生開二山平
崔嵬	從合一灰平 疑合一灰平
工行	見一東平 匣開一唐平
左傳	精開一歌上 澄合三仙去
左轉	精開一歌上 知合三仙上
差使	初開二佳平 生開三之上
差別	初開二麻平 幫三B仙入
差池	初開三支平 澄開三支平
差異	初開二佳平 以開三之去
差異	初開二麻平 以開三之去
差錯	初開二麻平 清開一唐入
帳号	知開三陽去 匣開一豪去
平反	並三B庚平 滂三C元平
平翹	並三B庚平 羣開三A宵去
平調	並三B庚平 定開四蕭去
年長	泥開四先平 知開三陽上
并州	幫三A清平 章三尤平
幾乎	見開三C微平 匣一模平
幾種	見開三C微上 章三鍾上
度支	定開一唐入 章開三支平
庶幾	書開三魚去 見開三C微平
延請	以開三仙平 從開三清去
彈出	定開一寒平 昌合三真入
彈劾	定開一寒平 匣開一登入
很少	匣開一痕上 書開三宵上
後來	匣一侯上 來開一咍平
後悔	匣一侯上 曉合一灰上
後燕	匣一侯上 影開四先平
後藏	匣一侯上 從開一唐去
從子	從三鍾去 精開三之上
從容	清三鍾平 以三鍾平
復旦	並三C東入 端開一寒去
復辟	並三C東入 幫三A清入
徵調	知開三之上 定開四蕭去
德操	端開一登入 清開一豪去
德行	端開一登入 匣開二庚去
必勝	幫三A真入 書開三蒸去
忖度	清合一魂上 定開一唐入
志操	章開三之去 清開一豪去
快樂	溪合二夬去 來開一唐入
恐怕	溪三C鍾去 滂二麻去
恐懼	溪三C鍾上 羣合三C虞去
恐襲	溪三C鍾上 邪開三侵入
悔過	曉合一灰去 見合一歌去
悖論	並一魂入 來合一魂去
悖逆	並一魂入 疑開三B庚入
情調	從開三清平 定開四蕭去
惡少	影開一唐入 書開三宵去
想要	心開三陽上 影開三A宵去
愛好	影開一咍去 曉開一豪去
慘重	清開一覃上 澄三鍾上
慰勞	影合三C微去 來開一豪去
懇切	溪開一痕上 清開四齊去
應姓	影開三C蒸平 心開三清去
應對	影開三C蒸去 端合一灰去
應爲	影開三C蒸平 云合三B支平
應當	影開三C蒸平 端開一唐平
應鐘	影開三C蒸去 章三鍾平
懊悔	影開一豪去 曉合一灰上
懊惱	影開一豪上 泥開一豪上
所在	生開三魚上 從開一咍去
扁舟	滂三A仙平 章三尤平
扁鵲	並四先上 清開三陽入
打轉	端開二庚上 知合三仙去
技校	羣開三B支上 匣開二肴去
投行	定一侯平 匣開一唐平
投降	定一侯平 匣二江平
抱養	並一豪上 以開三陽上
招行	章開三宵平 匣開一唐平
招降	章開三宵平 匣二江平
挑戰	定開四蕭上 章開三仙去
挑撥	透開四蕭平 幫一寒入
挑達	透開一豪平 透開一寒入
挑選	透開四蕭平 心合三仙上
排行	並二皆平 匣開一唐去
推倒	透合一灰平 端開一豪上
推出	昌合三脂平 昌合三真入
推導	昌合三脂平 定開一豪去
推廣	透合一灰平 見合一唐上
推敲	透合一灰平 溪開二肴平
推普	透合一灰平 滂一模上
推理	昌合三脂平 來開三之上
推舉	昌合三脂平 見開三C魚上
推薦	昌合三脂平 精開四先去
推行	透合一灰平 匣開二庚平
推選	昌合三脂平 心合三仙上
揖揖	清開三侵入 清開三侵入
揣度	初合三支上 定開一唐入
援交	云合三B仙去 見開二肴平
援引	云合三C元平 以開三真上
擅長	常開三仙去 澄開三陽平
操作	清開一豪平 精開一唐入
操姓	清開一豪去 心開三清去
操持	清開一豪去 澄開三之平
操行	清開一豪去 匣開二庚去
攀援	滂二刪平 云合三C元平
支援	章開三支平 云合三B仙去
改悔	見開一咍上 曉合一灰去
政治	章開三清去 澄開三之去
效率	匣開二肴去 來合三真入
救援	見三C尤去 云合三B仙去
教主	見開二肴去 章合三虞上
教學	見開二肴去 匣二江入
教師	見開二肴去 生開三脂平
教徒	見開二肴去 定一模平
教授	見開二肴去 常三尤去
教授	見開二肴平 常三尤去
教書	見開二肴平 書開三魚平
教會	見開二肴去 匣合一泰去
教會	見開二肴平 匣合一泰去
教的	見開二肴平 端開四青入
教程	見開二肴去 澄開三清平
教育	見開二肴去 以三東入
教課	見開二肴平 溪合一歌去
教長	見開二肴去 知開三陽上
教養	見開二肴去 以開三陽上
數字	生合三虞去 從開三之去
數學	生合三虞去 匣二江入
數數	生合三虞上 生合三虞去
數百	生二江入 幫二庚入
數量	生合三虞去 來開三陽去
料理	來開四蕭平 來開三之上
斷了	定合一寒上 來開四蕭上
斷絕	定合一寒上 從合三仙入
斷絕	端合一寒上 從合三仙入
於戲	影一模平 曉一模平
施于	以開三支去 云合三C虞平
旁聽	並一唐平 透開四青平
旁觀	並一唐平 見合一寒平
旅舍	來開三魚上 書開三麻去
早朝	精開一豪上 澄開三宵平
明朝	明三B庚平 澄開三宵平
易容	以開三清入 以三鍾平
易溶	以開三支去 以三鍾平
易用	以開三支去 以三鍾去
易經	以開三清入 見開四青平
春夏	昌合三真平 匣開二麻去
時閒	常開三之平 見開二山平
晉朝	精開三真去 澄開三宵平
景行	見開三B庚上 匣開二庚去
暑假	書開三魚上 見開二麻去
暴徒	並一豪去 定一模平
暴政	並一豪去 章開三清去
暴走	並一豪去 精一侯上
暴雨	並一豪去 云合三C虞上
暴露	並一東入 來一模去
曲調	溪三C鍾入 定開四蕭去
書函	書開三魚平 匣開二咸平
書畫	書開三魚平 匣合二佳去
曹參	從開一豪平 清開一覃平
曹操	從開一豪平 清開一豪去
曾參	精開一登平 生開三侵平
曾姓	精開一登平 心開三清去
曾經	從開一登平 見開四青平
最好	精合一泰去 曉開一豪上
最少	精合一泰去 書開三宵上
會稽	見合一泰去 見開四齊平
會計	見合一泰去 見開四齊去
月氏	疑合三C元入 章開三支平
有空	云三C尤上 溪一東去
朝代	澄開三宵平 定開一咍去
朝向	澄開三宵平 曉開三C陽去
朝夕	知開三宵平 邪開三清入
朝奉	澄開三宵平 並三C鍾上
朝廷	澄開三宵平 定開四青平
朝拜	澄開三宵平 幫二皆去
朝服	澄開三宵平 並三C東入
朝着	澄開三宵平 澄開三陽入
朝覲	澄開三宵平 羣開三B真去
朝請	澄開三宵平 從開三清去
朝陽	澄開三宵平 以開三陽平
朝陽	知開三宵平 以開三陽平
朝霞	知開三宵平 匣開二麻平
朝鮮	知開三宵平 心開三仙平
李朝	來開三之上 澄開三宵平
東莞	端一東平 見合一寒平
枸杞	見一侯上 溪開三C之上
某種	明一侯上 章三鍾上
栒邑	心合三真平 影開三B侵入
校內	匣開二肴去 泥合一灰去
校勘	見開二肴去 溪開一覃去
校友	匣開二肴去 云三C尤上
校園	匣開二肴去 云合三C元平
校址	匣開二肴去 章開三之上
校場	見開二肴去 澄開三陽平
校外	匣開二肴去 疑合一泰去
校官	匣開二肴去 見合一寒平
校尉	匣開二肴去 影合三C微去
校對	見開二肴去 端合一灰去
校徽	匣開二肴去 曉合三C微平
校慶	匣開二肴去 溪開三B庚去
校方	匣開二肴去 幫三C陽平
校服	匣開二肴去 並三C東入
校樣	見開二肴去 以開三陽去
校歌	匣開二肴去 見開一歌平
校正	見開二肴去 章開三清去
校準	見開二肴去 章合三真上
校舍	匣開二肴去 書開三麻去
校花	匣開二肴去 曉合二麻平
校草	匣開二肴去 清開一豪上
校覈	見開二肴去 匣開二耕入
校規	匣開二肴去 見合三A支平
校訂	見開二肴去 端開四青去
校訓	匣開二肴去 曉合三C文去
校長	匣開二肴去 知開三陽上
校驗	見開二肴去 疑開三B鹽去
椶種	精一東平 章三鍾上
概率	見開一咍去 來合三真入
樂亭	來開一唐入 定開四青平
樂句	疑二江入 見合三C虞去
樂園	來開一唐入 云合三C元平
樂官	疑二江入 見合一寒平
樂山	來開一唐入 生開二山平
樂意	來開一唐入 影開三C之去
樂感	疑二江入 見開一覃上
樂曲	疑二江入 溪三C鍾入
樂毅	疑二江入 疑開三C微去
樂清	疑二江入 清開三清平
樂章	疑二江入 章開三陽平
樂觀	來開一唐入 見合一寒平
標識	幫三A宵平 章開三之去
樸素	滂二江入 心一模去
樹上	常合三虞去 常開三陽上
樹幹	常合三虞去 見開一寒去
樹立	常合三虞上 來開三侵入
次數	清開三脂去 生合三虞去
次要	清開三脂去 影開三A宵去
欱水	曉開一覃入 書合三脂上
欱酒	曉開一覃入 精三尤上
歡樂	曉合一寒平 來開一唐入
正在	章開三清去 從開一咍上
正好	章開三清去 曉開一豪上
正月	章開三清平 疑合三C元入
正朔	章開三清平 生二江入
此處	清開三支上 昌開三魚去
步數	並一模去 生合三虞去
步行	並一模去 匣開二庚平
殺降	生開二山入 匣二江平
殿後	端開四先去 匣一侯上
殿軍	端開四先去 見合三C文平
母校	明一侯上 匣開二肴去
比鄰	並三A脂去 來開三真平
氣相	溪開三C微去 心開三陽去
汶川	明三B真平 昌合三仙平
決斷	見合四先入 端合一寒去
汽車	溪開三C微去 昌開三麻平
沮渠	精開三魚平 羣開三C魚平
注疏	章合三虞去 生開三魚去
注重	章合三虞去 澄三鍾上
洋行	以開三陽平 匣開一唐平
洪洞	匣一東平 定一東平
海相	曉開一咍上 心開三陽去
液相	以開三清入 心開三陽去
清朝	清開三清平 澄開三宵平
清華	清開三清平 匣合二麻平
測量	初開三蒸入 來開三陽平
湯湯	書開三陽平 書開三陽平
滑稽	見合一魂入 見開四齊平
漢朝	曉開一寒去 澄開三宵平
漢藏	曉開一寒去 從開一唐去
澹臺	定開一談平 定開一咍平
濟南	精開四齊上 泥開一覃平
濟寧	精開四齊上 泥開四青平
濟水	精開四齊上 書合三脂上
火圈	曉合一歌上 溪合三B仙平
火車	曉合一歌上 昌開三麻平
無射	明三C虞平 以開三清入
照相	章開三宵去 心開三陽去
燕京	影開四先平 見開三B庚平
燕國	影開四先平 見合一登入
燕子	影開四先去 精開三之上
燕山	影開四先平 生開二山平
燕王	影開四先平 云合三C陽平
燕郊	影開四先平 見開二肴平
爲主	云合三B支平 章合三虞上
爲了	云合三B支去 來開四蕭上
爲何	云合三B支去 匣開一歌平
爲此	云合三B支去 清開三支上
爲難	云合三B支平 泥開一寒平
爲首	云合三B支平 書三尤上
牛蒡	疑三C尤平 幫一唐上
物種	明三C文入 章三鍾上
犒勞	溪開一豪去 來開一豪去
狋氏	羣合三B仙平 精開三清平
理論	來開三之上 來合一魂去
番号	滂三C元平 匣開一豪去
番禺	滂一寒平 疑合三C虞平
當作	端開一唐平 精開一唐入
當值	端開一唐平 澄開三之去
當舖	端開一唐去 滂一模去
當行	端開一唐去 匣開一唐平
當鋪	端開一唐去 滂一模去
白種	並二庚入 章三鍾上
皇上	匣合一唐平 常開三陽去
監利	見開二銜去 來開三脂去
直下	澄開三蒸入 匣開二麻去
相互	心開三陽平 匣一模去
相伴	心開三陽平 並一寒上
相似	心開三陽平 邪開三之上
相位	心開三陽去 云合三B脂去
相傳	心開三陽平 澄合三仙平
相公	心開三陽去 見一東平
相冊	心開三陽去 初開二耕入
相同	心開三陽平 定一東平
相國	心開三陽去 見合一登入
相城	心開三陽去 常開三清平
相左	心開三陽平 精開一歌上
相府	心開三陽去 幫三C虞上
相悖	心開三陽平 並一灰去
相應	心開三陽平 影開三C蒸去
相撲	心開三陽平 滂一東入
相框	心開三陽去 溪合三C陽平
相機	心開三陽去 見開三C微平
相比	心開三陽平 幫三A脂上
相父	心開三陽去 並三C虞上
相爺	心開三陽去 以開三麻平
相片	心開三陽去 滂四先去
相符	心開三陽平 並三C虞平
相簿	心開三陽去 並一模上
相紙	心開三陽去 章開三支上
相處	心開三陽平 昌開三魚上
相親	心開三陽平 清開三真平
相變	心開三陽去 幫三B仙去
相貌	心開三陽去 明二肴去
相通	心開三陽平 透一東平
相逢	心開三陽平 並三C鍾平
相鄰	心開三陽平 來開三真平
相間	心開三陽平 見開二山去
相面	心開三陽去 明三A仙去
相類	心開三陽平 來合三脂去
相鼠	心開三陽去 書開三魚上
省略	生開三庚上 來開三陽入
看守	溪開一寒平 書三尤上
看家	溪開一寒平 見開二麻平
眞相	章開三真平 心開三陽去
着裝	知開三陽入 莊開三陽平
睡覺	常合三支去 見開二肴去
祁山	羣開三A脂平 生開二山平
票價	滂三A宵去 見開二麻去
票錢	滂三A宵去 從開三仙平
秋請	清三尤平 從開三清去
秦朝	從開三真平 澄開三宵平
種姓	章三鍾上 心開三清去
種子	章三鍾上 精開三之上
種族	章三鍾上 從一東入
種植	章三鍾去 常開三蒸入
種樹	章三鍾去 常合三虞去
種田	章三鍾去 定開四先平
種豬	章三鍾上 知開三魚平
種馬	章三鍾上 明二麻上
稽攷	見開四齊平 溪開一豪上
稽首	溪開四齊上 書三尤上
積分	精開三清入 幫三C文平
空當	溪一東去 端開一唐平
空缺	溪一東去 溪合三A仙入
空閑	溪一東去 匣開二山平
空閒	溪一東平 見開二山平
立夏	來開三侵入 匣開二麻去
等差	端開一登上 初開三支平
答應	端開一覃入 影開三C蒸去
節省	精開四先入 生開三庚上
簡易	見開二山上 以開三支去
純束	定合一魂平 書三鍾入
素質	心一模去 章開三真入
給予	見開三B侵入 以開三魚上
經過	見開四青平 見合一歌平
編号	幫四先平 匣開一豪去
總要	精一東上 影開三A宵去
羊圈	以開三陽平 羣合三C元上
翹楚	羣開三A宵平 初開三魚上
翹舌	羣開三A宵去 船開三仙入
翹起	羣開三A宵去 溪開三C之上
翹首	羣開三A宵平 書三尤上
聖上	書開三清去 常開三陽去
聲調	書開三清平 定開四蕭去
背棄	並一灰去 溪開三A脂去
胖子	滂二江去 精開三之上
自首	從開三脂去 書三尤去
臯陶	見開一豪平 以開三宵平
至少	章開三脂去 書開三宵上
與會	以開三魚去 匣合一泰去
般師	幫二刪平 生開三脂平
般運	幫一寒平 云合三C文去
芍藥	常開三陽入 以開三陽入
花費	曉合二麻平 滂三C微去
芳菲	滂三C陽平 滂三C微平
茶几	澄開二麻平 見開三B脂上
荷花	匣開一歌平 曉合二麻平
荸薺	並一魂入 從開三脂平
莞爾	匣合二刪上 日開三支上
莽蒼	明一唐上 清開一唐上
菏澤	見開一歌平 澄開二庚入
菝葜	並二山入 溪開二山入
菝𦸉	並二山入 溪開二山入
華僑	匣合二麻平 羣開三B宵平
華夏	匣合二麻平 匣開二麻上
華山	匣合二麻去 生開二山平
菲薄	滂三C微上 並一唐入
落魄	來開一唐入 透開一唐入
著名	知開三魚去 明三A清平
蒸乾	章開三蒸平 見開一寒平
薜荔	並四齊去 來開四齊去
藏人	從開一唐去 日開三真平
藏區	從開一唐去 溪合三C虞平
藏品	從開一唐平 滂三B侵上
藏彝	從開一唐去 以開三脂平
藏族	從開一唐去 從一東入
藏書	從開一唐平 書開三魚平
藏緬	從開一唐去 明三A仙上
藏身	從開一唐平 書開三真平
處在	昌開三魚上 從開一咍上
處女	昌開三魚上 孃開三魚上
處子	昌開三魚上 精開三之上
處方	昌開三魚上 幫三C陽平
處於	昌開三魚上 影開三C魚平
處暑	昌開三魚上 書開三魚上
處理	昌開三魚上 來開三之上
處置	昌開三魚上 知開三之去
蜲蛇	影合三B支平 以開三支平
蟾蜍	常開三鹽平 常開三魚平
蟾蠩	章開三鹽平 章開三魚平
蟾諸	章開三鹽平 章開三魚平
行乞	匣開二庚平 溪開三C殷入
行了	匣開二庚平 來開四蕭上
行事	匣開二庚平 崇開三之去
行人	匣開二庚平 日開三真平
行伍	匣開一唐平 疑一模上
行兇	匣開二庚平 曉三C鍾平
行刑	匣開二庚平 匣開四青平
行列	匣開一唐平 來開三仙入
行刺	匣開二庚平 清開三支去
行動	匣開二庚平 定一東上
行号	匣開一唐平 匣開一豪去
行商	匣開二庚平 書開三陽平
行善	匣開二庚平 常開三仙上
行在	匣開二庚平 從開一咍去
行好	匣開二庚平 曉開一豪上
行家	匣開一唐平 見開二麻平
行寬	匣開一唐平 溪合一寒平
行將	匣開二庚平 精開三陽平
行屍	匣開二庚平 書開三脂平
行徑	匣開二庚平 見開四青去
行情	匣開一唐平 從開三清平
行房	匣開二庚平 並三C陽平
行政	匣開二庚平 章開三清去
行數	匣開一唐平 生合三虞去
行星	匣開二庚平 心開四青平
行書	匣開二庚平 書開三魚平
行會	匣開一唐平 匣合一泰去
行李	匣開二庚平 來開三之上
行板	匣開二庚平 幫二刪上
行業	匣開一唐平 疑開三C嚴入
行楷	匣開二庚平 溪開二皆上
行樂	匣開二庚平 來開一唐入
行權	匣開二庚平 羣合三B仙平
行爲	匣開二庚平 云合三B支平
行當	匣開一唐平 端開一唐去
行省	匣開二庚平 生開三庚上
行禮	匣開二庚平 來開四齊上
行竊	匣開二庚平 清開四先入
行署	匣開二庚平 常開三魚去
行者	匣開二庚平 章開三麻上
行草	匣開二庚平 清開一豪上
行裝	匣開二庚平 莊開三陽平
行話	匣開一唐平 匣合二夬去
行貨	匣開一唐平 曉合一歌去
行賄	匣開二庚平 曉合一灰上
行賞	匣開二庚平 書開三陽上
行走	匣開二庚平 精一侯上
行距	匣開一唐平 羣開三C魚上
行路	匣開二庚平 來一模去
行蹤	匣開二庚平 精三鍾平
行車	匣開二庚平 昌開三麻平
行進	匣開二庚平 精開三真去
行道	匣開二庚平 定開一豪上
行醫	匣開二庚平 影開三C之平
行銷	匣開二庚平 心開三宵平
行長	匣開一唐平 知開三陽上
行雲	匣開二庚平 云合三C文平
行頭	匣開二庚平 定一侯平
行騙	匣開二庚平 滂三A仙去
行高	匣開一唐平 見開一豪平
衞藏	云合三B祭去 從開一唐去
複雜	幫三C東入 從開一覃入
西夏	心開四齊平 匣開二麻上
西燕	心開四齊平 影開四先平
西藏	心開四齊平 從開一唐去
要不	影開三A宵去 幫三C文入
要事	影開三A宵去 崇開三之去
要挾	影開三A宵平 匣開四添入
要服	影開三A宵平 並三C東入
要求	影開三A宵平 羣三C尤平
要約	影開三A宵平 影開三C陽入
要請	影開三A宵平 清開三清上
覆滅	滂三C東入 明三A仙入
覆蓋	滂三C尤去 見開一泰去
觀光	見合一寒平 見合一唐平
觀感	見合一寒平 見開一覃上
觀景	見合一寒平 見開三B庚上
觀望	見合一寒平 明三C陽去
觀看	見合一寒平 溪開一寒去
觀衆	見合一寒平 章三東去
角直	來一東入 澄開三蒸入
角里	來一東入 來開三之上
計劃	見開四齊去 匣合二耕入
計畫	見開四齊去 匣合二佳去
計畫	見開四齊去 匣合二耕入
評論	並三B庚平 來合一魂去
試劑	書開三之去 從開四齊去
語種	疑開三C魚上 章三鍾上
說客	書合三祭去 溪開二庚入
說服	書合三祭去 並三C東入
說過	書合三仙入 見合一歌去
調值	定開四蕭去 澄開三蒸入
調性	定開四蕭去 心開三清去
調情	定開四蕭平 從開三清平
調整	定開四蕭平 章開三清上
調理	定開四蕭平 來開三之上
調琴	定開四蕭平 羣開三B侵平
調節	定開四蕭平 精開四先入
調解	定開四蕭平 見開二佳上
調音	定開四蕭平 影開三B侵平
調飢	知三尤平 見開三B脂平
論語	來合一魂平 疑開三C魚上
諡号	船開三脂去 匣開一豪去
諸曁	章開三魚平 見開三C微去
變徵	幫三B仙去 知開三之上
變易	幫三B仙去 以開三清入
谷蠡	來一東入 來開三支平
豬圈	知開三魚平 羣合三C元上
負荷	並三C尤上 匣開一歌上
財會	從開一咍平 見合一泰去
貫穿	見合一寒平 昌合三仙平
費姓	並三C微去 心開三清去
費縣	幫三B脂去 匣合四先去
貿易	明一侯去 以開三清入
質子	知開三脂去 精開三之上	0%
質子	章開三真入 精開三之上
質押	知開三脂去 影開二銜入
質樸	章開三真入 滂二江入
質量	章開三真入 來開三陽去
跑圈	滂二肴上 溪合三B仙平
跑調	滂二肴上 定開四蕭去
身分	書開三真平 並三C文去
車主	昌開三麻平 章合三虞上
車票	昌開三麻平 滂三A宵去
車道	昌開三麻平 定開一豪上
車隊	昌開三麻平 定合一灰去
較易	見二江入 以開三支去
輸贏	書合三虞平 以開三清平
輸送	書合三虞去 心一東去
轉了	知合三仙上 來開四蕭上
轉交	知合三仙上 見開二肴平
轉告	知合三仙上 見開一豪去
轉圈	知合三仙去 溪合三B仙平
轉型	知合三仙上 匣開四青平
轉寫	知合三仙上 心開三麻上
轉帳	知合三仙上 知開三陽去
轉彎	知合三仙上 影合二刪平
轉成	知合三仙上 常開三清平
轉換	知合三仙上 匣合一寒去
轉會	知合三仙上 匣合一泰去
轉發	知合三仙上 幫三C元入
轉盤	知合三仙去 並一寒平
轉賬	知合三仙上 知開三陽去
轉載	知合三仙上 從開一咍去
轉送	知合三仙上 心一東去
轉速	知合三仙去 心一東入
轉運	知合三仙上 云合三C文去
這些	章開三麻上 心開三麻平
通量	透一東平 來開三陽去
造次	清開一豪去 清開三脂去
造訪	清開一豪去 滂三C陽去
連坐	來開三仙平 從合一歌上
進度	精開三真去 定一模去
進藏	精開三真去 從開一唐去
進行	精開三真去 匣開二庚平
遊說	以三尤平 書合三祭去
運載	云合三C文去 從開一咍去
運輸	云合三C文去 書合三虞去
過去	見合一歌去 溪開三C魚去
過失	見合一歌去 書開三真入
過錯	見合一歌去 清開一唐入
道觀	定開一豪上 見合一寒去
遞相	定開四齊上 心開三陽平
避難	並三A支去 泥開一寒去
邊塞	幫四先平 心開一咍去
邪惡	邪開三麻平 影開一唐入
邪教	邪開三麻平 見開二肴去
邯鄲	匣開一寒平 端開一寒平
部伍	並一模上 疑一模上
部曲	並一模上 溪三C鍾入
部署	並一侯上 常開三魚去
部隊	並一模上 定合一灰去
郵遞	云三C尤平 定開四齊去
配種	滂一灰去 章三鍾上
重出	澄三鍾平 昌合三真入
重合	澄三鍾平 匣開一覃入
重心	澄三鍾上 心開三侵平
重慶	澄三鍾平 溪開三B庚去
重新	澄三鍾平 心開三真平
重紐	澄三鍾平 孃三尤上
重組	澄三鍾平 精一模上
重複	澄三鍾平 並三C尤去
重要	澄三鍾上 影開三A宵去
重視	澄三鍾上 常開三脂去
重量	澄三鍾上 來開三陽去
重鈕	澄三鍾平 孃三尤上
重音	澄三鍾上 影開三B侵平
重韻	澄三鍾平 云合三C文去
重點	澄三鍾上 端開四添上
針刺	章開三侵平 清開三清入
銀行	疑開三B真平 匣開一唐平
錯亂	清開一唐入 來合一寒去
錯綜	清開一唐入 精一冬去
錯誤	清開一唐入 疑一模去
錯開	清開一唐入 溪開一咍平
錯雜	清開一唐入 從開一覃入
鏈接	來開三仙去 精開三鹽入
長假	澄開三陽平 見開二麻去
長子	知開三陽上 精開三之上
長孫	知開三陽上 心合一魂平
長幼	知開三陽上 影開三A幽去
長興	澄開三陽平 曉開三C蒸平
長調	澄開三陽去 定開四蕭去
閼氏	影開四先平 章開三支平
阮朝	疑合三C元上 澄開三宵平
阿房	影開一歌平 並一唐平
附和	並三C虞去 匣合一歌去
附着	並三C虞去 澄開三陽入
附近	並三C虞去 羣開三C殷上
降伏	匣二江平 並三C東入
降兵	匣二江平 幫三B庚平
降服	匣二江平 並三C東入
降落	見二江去 來開一唐入
院校	云合三B仙去 匣開二肴去
離別	來開三支平 並三B仙入
離别	來開三支平 並三B仙入
難易	泥開一寒平 以開三支去
雨燕	云合三C虞上 影開四先去
雪颮	心合三仙入 幫三A宵平
電腦	定開四先去 泥開一豪上
電荷	定開四先去 匣開一歌上
青少	清開四青平 書開三宵去
青藏	清開四青平 從開一唐去
面相	明三A仙去 心開三陽去
靺鞨	明一寒入 匣開一寒入
音樂	影開三B侵平 疑二江入
頻率	並三A真平 來合三真入
飄過	滂三A宵平 見合一歌平
食其	以開三之去 見開三C之平
飲馬	影開三B侵去 明二麻上
餘汗	以開三魚平 見開一寒平
馬車	明二麻上 昌開三麻平
騎車	羣開三B支平 昌開三麻平
高校	見開一豪平 匣開二肴去
高要	見開一豪平 影開三A宵平
魚乾	疑開三C魚平 見開一寒平
鮟鱇	影開一寒平 溪開一唐平
黃種	匣合一唐平 章三鍾上
黎朝	來開四齊平 澄開三宵平
黑種	曉開一登入 章三鍾上
點當	端開四添上 端開一唐去
鼻冠	並三A脂去 見合一寒去
龜兹	溪三C尤平 從開三之平
龜兹	見三C尤平 從開三之平
一刀切	影開三A真入 端開一豪平 清開四先入
乾兒子	見開一寒平 日開三支平 精開三之上
二人轉	日開三脂去 日開三真平 知合三仙去
代謝率	定開一咍去 邪開三麻去 來合三真入
函谷關	匣開二咸平 見一東入 見合二刪平
南北朝	泥開一覃平 幫一登入 澄開三宵平
吐谷渾	透一模上 以三鍾入 匣合一魂平
大汶口	定開一泰去 明三C文去 溪一侯上
將進酒	清開三陽平 精開三真去 精三尤上
推普機	透合一灰平 滂一模上 見開三C微平
教數學	見開二肴平 生合三虞去 匣二江入
教育部	見開二肴去 以三東入 並一侯上
教語文	見開二肴平 疑開三C魚上 明三C文平
暴風雨	並一豪去 幫三C東平 云合三C虞上
朋友圈	並一登平 云三C尤上 溪合三B仙平
李世乭	來開三之上 書開三祭去 定合一魂入
校醫院	匣開二肴去 影開三C之平 云合三B仙去
梅乾菜	明一灰平 見開一寒平 清開一咍去
爲什麼	云合三B支去 常開三侵入 明一歌平
白雲觀	並二庚入 云合三C文平 見合一寒去
祁連山	羣開三A脂平 來開三仙平 生開二山平
紅種人	匣一東平 章三鍾上 日開三真平
自乾五	從開三脂去 見開一寒平 疑一模上
自行車	從開三脂去 匣開二庚平 昌開三麻平
要不然	影開三A宵去 幫三C文入 日開三仙平
觀前街	見合一寒去 從開四先平 見開二佳平
豆腐乾	定一侯去 並三C虞上 見開一寒平
進化論	精開三真去 曉合二麻去 來合一魂去
電動車	定開四先去 定一東上 昌開三麻平
青少年	清開四青平 書開三宵去 泥開四先平
高句驪	見開一豪平 見一侯平 來開三支平
不亦說乎	幫三C文入 以開三清入 以合三仙入 匣一模平
六出祁山	來三東入 昌合三真入 羣開三A脂平 生開二山平
十年樹木	常開三侵入 泥開四先平 常合三虞上 明一東入
審時度勢	書開三侵上 常開三之平 定開一唐入 書開三祭去
推心置腹	透合一灰平 心開三侵平 知開三之去 幫三C東入
斷其後路	端合一寒上 羣開三C之平 匣一侯上 來一模去
旦復旦兮	端開一寒去 並三C尤去 端開一寒去 匣開四齊平
朝三暮四	知開三宵平 心開一談平 明一模去 心開三脂去
朝朝暮暮	知開三宵平 知開三宵平 明一模去 明一模去
百年樹人	幫二庚入 泥開四先平 常合三虞上 日開三真平
知識分子	知開三支平 書開三蒸入 並三C文去 精開三之上
宮商角徵羽	見三C東平 書開三陽平 見二江入 知開三之上 云合三C虞去
